111111111111111111111111111111111111111111111111111111111111111111111111111111111111111111
100000000000010111010001000001100000000000000000000000000000101000001000101000000000000011
111011117111010000010101010100001111110101111111101011111110101011101010101011111111111011
101010000001011161010101010111100011000101000000001010000010101010100010101011111111111011
101000101101000000010101010000101011011101011111111010000010100010101110101011111111111011
101111100001111011110101010110101011011101011111111010000010111110101000101011111111111011
100000001001001000000001000010101011011101000000001011111110000000001111101011171111111011
111111011001001101111101101010101011011101111111101010000010101111000011101000000000000011
100000001001000000000000101000101011011600000000101010111010101001111000101111111110101011
101111111001111111111110101011101011011101111110101010101010101000001110100000000010101011
101001000000000000000010100010001011011100000010101010101010101111000010111111111010101011
101101011111111111111010101010111011011101111110101010101010100001011010100000000011111011
100000000000000000001010000010100011000100000000101010101010111111011010101000016110100011
111101011111111111101010111110101111110101111111101010101011100000000010101000100010101011
100001000000000000001010000001000000000100000000000010011010001111110010111011111010101011
101111011111111111111011101111111101111111111111111110001011001000000010001010001010101011
100001000000000000000000100000000000000000000000000011101001001011171110101110101110001011
111101111111111111111110111111111111111111111111111010100000001000000000100010100000111111
101000001010000010100000100000000000000000000000001010111111111011111111101010111111100011
101011101011111000111110111101111101107101101101101010101000000000001000001010000000001011
101010101000000000001010000000000101101101101101101010101011111111001010111011111116111011
101110101011111111101011111111110101101101101101101010100010000001001010101000001000001011
100000000010000000000000000000010101101101101101101010111110111101001010101110101110101011
101110111111111111101111111111010101101101101101101010100000000000000010100000100000101011
101010001000010000101010100000010101101101101101101010111111110111111110111100111111101011
101011101111010110101000001101010101101101101101101010000001010101000100010000010000000011
101000000001010110101110101101010101101101101101101011111111010100010001011111010111111111
101011111101000000000011101101000100000000000000001010000001001011111111110001010000000011
101000000101010101011000101101111161111101111111111010111111100000000000011101111111101011
101611111101011111111011111100000000000100000000000010100000101111101110010101000000001011
100010000000010000100000000001011111110101111111111110101110101000000010010101111111001011
101011111111111010111111111111011111110000000100010100001010111011101010010100000001111111
101000000010001010000000000001071111110110110101010111111010000010101011110111111101000011
111111111011101011111101111101011111110100010101010100000010111010101010000000000001111011
100000001010000010000000000101011111110101010001000100000010101010101010011111110000000011
101010101010101010011101110101111111111101011111101111111110101110101010010000011111111111
101110101110101010010000010100000000000001000000101000000000100000101000010111010000000011
100000100000101010011111110101111111111111111110101111111111101111101111110101011011111011
101110001010000010000000000101010000010001000000101000100001001010101000000100000000000011
101011111011111110011111111101011111011101111110101010101011101010101111110101111111111011
101010001010000000000000000001000100000001000000101010001000101010100000000101000000001011
101010101010011001111111111101010101110101011110101111111010101010111111110101016111101011
101010100010000001000010000101010111111101011110100000001010101010100000010101000000101011
101010111111101111111010110101010000000001011110111101101010101010101101010101111111101011
101000000000001000000010110101111111111111011110100000101010101010101101010100000000001011
101111111111101111011110110100000101000100010010001110101010111010107101010101111011111011
100000100000000000000010110111110100010001000000101110101010000010101101010000000100001011
111110101111011111111010110000010111111111111111111111101011111110111111011111111111111011
100100100000010001000000111111010000000000000000000000000000000000000000000000000000000011
110100111111110101011110111111010111111111111111111111111111111111111111111010101111111111
100100000000000001010000100000010100000000100001000100010001000000000000001010101000000011
101117111111111101010101111111010111101110101100010101000100000111111611101010101111111011
101000000000000101010101000000000000101010100101010111111111110111111111101010101000000011
101011111111110101010101011111111161101010111111010000000000010111111111101010101110111111
101011111111110101010101000100000000001010000000010111011111010111111111101010101010100011
101071111111110101010101010111111111111011111711110100010001010111111111101000101010101011
101011111111110101000100010100000000000010000000000101000101010000000000001110101010101611
101011111111110101111111110111111111111011111111110101111101011111111111111000101010101011
101011111111110100000000000000000000000000000000010101000000000000000000001010101010001011
101011111111110111111111111111111111111111111111010101111111111111111111107010101011111011
101011111111110101000000000000000000000000000001010101000000000000000000101010101010100011
101061111111110101011111111611111111111111111101011101011111111111111110111110101010001011
101011111111110101011111111111111111111111111101000000000000000000000000000000101011101011
101000000000000001011111111111111111111111111101010111111111111111011111161111101010101011
101111111111111101000111111111117000000000000001010100000000000001010000000000001000101011
100000000000000001110111111111111011111111111111010101111111111101011111111111111010101011
111111111111111101010111111111111010000000000001010101000100010101011111111111111010101011
100000000000000000010111111111111011111111110101010100010001000101000000000000000010101011
111111111111111111010111111111111000000000000001010111111111111101011111111111111111111011
100000000000000001010711111111111011111111111111000000000000000001010000000000000000000011
101101101101101101010000000000000010000000000001010111111111111111011111111111111111011111
101101101101101101010111111111111110111111111101000000000000000000000000000000000001000011
101101101101101101010111000000000000100000000101111111111111111111111111111111111101011011
107101101101101101110001011111111111110111110100000000010000000000000000000001000101011011
101101101101101100011101010000000000010101010111111111011111111111111111111101110101017011
101101101101101101010101010111111111010100000000000001010100001000100010000001010101011011
101101101101101101010100010101000000010101111111110101010001000010001010010100010101011011
101101101101101101010111010001011111010100000100000101010111111111111010110111110101011011
101101101101101101000000010101010001010101111111110101010100000000000010100000000101011011
100000000000000001111111010000010101010100000100000101010111111611111110101111111101011011
101101101101101101010101010101010111010111111111011101000000000000000000101000000101111111
101101101101101101010100010001010000010000000001010001111111111111111110101011110100000011
101101101101101101010101011111111111111111111111010100000000000000000000101011110111111011
101101101101101101010001000000000000000000000000010101111111111111011100101000000000001011
101101101101101101011111116111111111111111111111111100000000000001010100101111111111101011
101101101101101101000001000100010001000100010001000101111111111111010111100010001000101011
101101101101101101110101010101010101010101010101010101000000000000010000001000100010101011
101101101101101101010101010101010701010101010101010101011111111111111111111111111111107011
101101101101101101000100010001000100010001000100010001000000000000000000000000000000000011
111111111111111111111111111111111111111111111111111111111111111111111111111111111111111111
